######################################################################
......................................................................
................#.....................................................
................#.....................................................
................#.....................................................
................#.....................................................
................#.....................................................
................#.....................................................
......................................................................
......................................................................
......................................................................
......................................................................
......................................................................
.................................................#....................
.................................................#....................
.................................................#....................
.................................................#....................
.................................................#....................
.................................................#....................
......................................................................
......................................................................
......................................................................
......................................................................
................#.....................................................
................#.....................................................
................#.....................................................
................#.....................................................
................#.....................................................
................#.....................................................
......................................................................
......................................................................
......................................................................
......................................................................
######################################################################